{Título Principal, fonte verdana, verde e tamanho 20pt} Lista de tags e atributos CSS

{Tabela com borda de 1 pixel e duas colunas}
{Coluna 1} ATRIBUTO DE CSS	{Coluna 2} O QUE ELE CONFIGURA
{Coluna 1} background	        {Coluna 2} cor de fundo, imagem, transparência.
{Coluna 1} background-image	{Coluna 2} imagem de fundo.
{Coluna 1} background-color	{Coluna 2} cor de fundo ou transparência.
{Coluna 1} border	        {Coluna 2} largura, estilo e cor de todas as 4 bordas.
{Coluna 1} border-color	        {Coluna 2} cor das 4 bordas.
{Coluna 1} border-style	        {Coluna 2} estilo de todas as 4 boras.
{Coluna 1} border-width	        {Coluna 2} largura de todas as 4 bordas.
{Coluna 1} color	        {Coluna 2} cor de primeiro plano.
{Coluna 1} float	        {Coluna 2} se o elemento flutua.
{Coluna 1} font	                {Coluna 2} estilo, variante, peso, tamanho e altura da linha do tipo de fonte.
{Coluna 1} font-family	        {Coluna 2} tipo de fonte.
{Coluna 1} font-size	        {Coluna 2} tamanho da fonte.
{Coluna 1} font-style	        {Coluna 2} fonte itálico.
{Coluna 1} font-weight	        {Coluna 2} peso da fonte de claro a negrito.
{Coluna 1} height	        {Coluna 2} altura exibida ao elemento.
{Coluna 1} left	                {Coluna 2} posição do elemento em relação a margem esquerda da página.
{Coluna 1} list-style	        {Coluna 2} tipo, imagem e posição do estilo da lista.
{Coluna 1} margin	        {Coluna 2} tamanho de todas as 4 margens.
{Coluna 1} padding	        {Coluna 2} espaço em torno de um elemento em todos os lados.
{Coluna 1} position	        {Coluna 2} como o elemento é posicionado na página.
{Coluna 1} text-align	        {Coluna 2} alinhamento do texto.
{Coluna 1} text-decoration	{Coluna 2} sublinhado, sobrelinhado ou riscado.
{Coluna 1} top	                {Coluna 2} posição do elemento em relação a parte superior da página.
{Coluna 1} width	        {Coluna 2} largura do elemento.

{Âncora para a primeira página. Fonte arial, verde e tamanho 14pt} Voltar para Primeira Página